╔════╦════════╦════════╦════╗
║12  ║p   e   ║  e    p║   e║
║34  ╚═══════D╩D═══════╝    ╚╗
║    D                eD   pk║
║    ╔═══════X╦X═══════╗    ╔╝
║    ║m       ║       p║   e║
╠════╬D═══════╬═══════D╬════╣
║ e  ║       e║       e║  e ║
║    D    ╔═══╬═══╗    D    ║
║    ║    ║   ║   ║    ║    ║
║    ║       mXp       ║    ║
║    ║    ║   ║   ║    ║    ║
║    ║    ╚═══╬═══╝    ║    ║
║    D       e║        D    ║
║ e  ╠════════╬════════╣  e ║
║    ║e      k║k      e║    ║
║    ║       e║        ║    ║
║    D    ╔═══╩═══╗    D   p║
╚════╣e   X   E   X   e╠════╝
     ╚════╩═══════╩════╝